111111111111111111111111111111111111111111
1EC000000000000000000000000000000000000001
1C1111111111111111111111111111111111111101
101000000000000000000000000000000000000101
101000000000000000000000000000000000000101
101000000000000000000000000000000000000101
101000000000000000000000000000000000000101
101000000000000000000000000000000000000101
101000000000000000000000000000000000000101
101000000000000000000000000000000000000101
101000000000000000000000000000000000000101
101000000000000000000000000000000000000101
101000000000000000000000000000000000000101
101000000000000000000000000000000000000101
101000000000000000000000000000000000000101
101000000000000000000000000000000000000101
101000000000000000000000000000000000000101
101000000000000000000000000000000000000101
101000000000000000000000000000000000000101
101111111111111111111111111111111111111101
1000000000000000000000000000000000000000P1
111111111111111111111111111111111111111111