1111111111
1E00000001
1000111001
10001C00P1
1111111111