1111111111
1E000000M1
1C00111001
1C001M10P1
1111111111