11111111111111111111111
1E0000000000000000000M1
10111111111011111111101
10100000000000000000101
10101111111111111110101
10101000000000000010101
10101011111011111010101
10101010C00000C01010101
1010101C1111111C1010101
1010101010C0C0101010101
101010101C1C1C101010101
1010001000C1C0001000101
101010101C1C1C101010101
1010101010C0C0101010101
1010101C1111111C1010101
10101010C00000C01010101
10101011111011111010101
10101000000000000010101
10101111111111111110101
10100000000000000000101
10111111111011111111101
1M0000000000000000000P1
11111111111111111111111