11111111
1P001001
100010E1
1C0000C1
11111111