111111111111111
1E000001MMM0001
10001001MMM0001
1C0000C111C1111
100000000000001
100010010001001
100000000000001
1C0000C1C000PC1
111111111111111