111111111111111
1E0000000001001
100010000000001
1C0000C1C0000C1
100000000000001
100010010001001
100000000000001
1C0000C1C000PC1
111111111111111